1111111111111111111111111111
1CCCCCCCCCCCC11CCCCCCCCCCCC1
1C1111C11111C11C11111C1111C1
1C1111C11111C11C11111C1111C1
1C1111C11111C11C11111C1111C1
1CCCCCCCCCCCCCCCCCCCCCCCCCC1
1C1111C11C11111111C11C1111C1
1C1111C11C11111111C11C1111C1
1CCCCCC11CCCC11CCCC11CCCCCC1
11C111C11111011G11111C111111
11C111C11111011011111C111111
11C111C10000000000001C111111
11C111C10111100111101C111111
1CCCCCC000B0000R00000C0000E1
11C111C10111100111101C111111
11C111C10000000000001C111111
11C111C10111111111101C111111
1CCCCCCCCCCCC11CCCCCCCCCCCC1
1C1111C11111C11C11111C1111C1
1C1111C11111C11C11111C1111C1
1CCC11CCCCCCC00CCCCCCC11CCC1
111C11C11C11111111C11C11C111
111C11C11C11111111C11C11C111
1CCCCCC11CCCC11CCCC11CCCCCC1
1CD111111111C11C1111111111C1
1CCCCCCCCCCCCCPCCCCCCCCCCCC1
1111111111111111111111111111
