11111111111111111111
1CCCC1CCCCCCCC1CCCC1
1C11C1C111111C1C11C1
1C1CCCCCCCCCCCCCC1C1
1C1C11C110011C11C1C1
1CCCCCC11MCE1CCCCCC1
1C1C11C111111C11C1C1
1C1CCCCCCCCCCCCCC1C1
1C11C1C111111C1C11C1
1CCCC1CCCPCCCC1CCCC1
11111111111111111111