11111111111111111111
1CCCCCC1CC111CCCCBC1
1C11CCC1CC011CCC11C1
1C1CC1CCCGCCCC1CE1C1
1C11C1C111111C1C11C1
1CCCCCCCCPCCCCCCCCC1
11111111111111111111
