11111111111111111111
1CCCCCC1M0011CCCCCC1
1C11CCC110011CCC11C1
1C1CC1CCCCCCCC1CE1C1
1C11C1C111111C1C11C1
1CCCCCCCCPCCCCCCCCC1
11111111111111111111
