11111111111111111111
1CCCCCC1CC111CCCCRC1
1C11CCC1CC011CCC11C1
1G1CC1CCCCCCCC1CE1C1
1C11C1C111111C1C11C1
1DCCCCCCCPCCCCCCCBC1
11111111111111111111
